0,1,2,5,3,2,4,3,5,5,2,1,2,1,5,1,1,2,6,0,
2,2,2,0,1,7,3,5,8,2,1,0,1,1,1,1,2,2,1,2,
7,7,1,1,5,5,3,5,5,5,1,0,2,0,0,1,7,2,1,1,
3,2,5,5,1,3,5,3,2,5,1,1,5,1,2,8,3,2,2,3,
2,7,1,3,0,0,1,1,2,1,3,2,1,3,3,1,7,2,1,1,
1,2,7,3,5,5,3,7,0,3,1,2,3,1,1,2,2,0,2,7,
2,0,1,5,5,1,0,3,1,3,2,0,0,2,3,0,1,0,1,2,
0,5,1,7,5,3,3,5,3,1,2,1,0,1,1,2,0,0,2,1,
2,3,2,7,1,5,5,5,5,3,3,2,0,8,3,2,0,2,1,3,
3,5,5,5,2,3,3,3,1,5,5,7,2,5,1,3,0,1,2,3,
6,0,1