0,4,1,3,7,3,2,3,1,1,7,2,2,0,1,0,7,2,6,2,
5,5,5,7,1,2,2,7,6,1,1,7,1,2,1,5,1,0,2,0,
3,5,3,5,3,3,5,3,3,2,7,1,2,2,5,3,7,2,1,2,
1,1,5,5,1,1,2,3,3,5,5,2,1,1,2,0,1,0,0,2,
2,2,3,0,2,1,1,2,1,2,0,0,1,0,7,0,2,1,2,2,
0,1,2,7,3,5,5,3,2,2,1,1,2,1,2,1,2,1,7,0,
7,1,1,2,3,1,5,3,2,5,5,1,1,0,2,0,2,5,2,2,
3,3,7,3,3,2,3,5,1,3,1,2,2,0,0,0,0,3,1,2,
3,3,2,3,3,2,3,8,5,2,1,1,0,0,2,0,2,2,0,2,
2,2,1,3,3,3,7,3,5,3,5,2,1,1,2,2,1,0,0,7,
1,0,5