0,1,2,7,5,3,3,3,5,5,2,1,2,1,2,7,5,2,6,3,
5,5,1,5,5,5,5,3,2,5,2,7,0,2,7,0,0,2,1,2,
5,1,7,1,2,1,2,3,3,5,3,0,1,1,1,2,2,1,5,5,
2,2,5,2,5,1,7,3,3,3,1,2,1,1,7,1,1,2,0,1,
5,1,2,1,0,3,5,5,1,1,2,1,0,1,1,2,1,1,1,5,
3,2,1,3,1,7,1,6,3,3,0,3,0,1,1,1,1,1,5,3,
3,1,4,3,2,0,0,2,2,3,0,2,0,2,7,5,2,2,0,2,
7,1,1,3,2,0,3,1,7,2,2,2,0,2,5,1,2,2,1,2,
7,3,0,3,5,3,1,5,2,2,2,1,2,2,7,1,2,1,2,3,
1,1,1,3,2,5,7,1,1,1,7,7,7,1,2,0,0,1,1,2,
2,6,7