0,1,2,1,2,2,1,1,5,5,1,5,5,3,1,2,1,0,6,3,
5,8,7,2,3,3,7,5,1,7,2,0,7,7,1,1,3,1,3,7,
5,3,3,3,8,0,1,1,1,0,1,2,2,0,1,2,3,2,2,0,
5,1,3,5,3,7,1,2,7,2,1,1,2,1,3,1,0,2,2,1,
2,3,5,5,2,2,5,3,2,0,2,2,2,3,1,0,2,2,0,2,
1,7,3,3,5,2,3,3,1,1,2,2,0,1,8,1,1,0,2,1,
0,7,3,3,3,1,3,1,2,1,4,2,0,1,2,3,2,1,2,2,
2,7,2,3,1,7,1,2,1,1,2,0,2,3,1,2,3,1,1,7,
3,7,1,7,2,5,3,2,1,1,2,0,1,2,2,1,3,2,1,0,
2,1,2,2,1,5,2,0,0,0,2,0,0,2,7,0,1,1,2,1,
10,6,1