4,3,5,3,3,3,5,3,5,3,3,0,8,8,8,8,8,8,6,6,
6,8,8,8,8,8,8,8,8,8,8,8,8,8,8,8,8,6,6,6,
8,8,8,8,8,8,8,8,8,8,8,8,8,8,8,8,6,6,6,6,
8,8,8,8,8,8,8,8,8,8,8,8,8,8,8,6,6,6,6,6,
8,8,8,8,8,8,8,8,8,8,8,8,8,8,6,6,6,6,6,6,
8,8,8,8,8,8,8,8,8,8,8,8,8,6,6,8,6,6,6,6,
8,8,8,8,8,8,8,8,8,8,8,8,8,6,6,6,6,6,6,6,
8,8,8,8,8,8,8,8,8,8,8,6,6,6,6,6,6,6,6,6,
8,8,8,2,8,8,8,8,8,8,6,6,6,6,6,6,6,6,6,6,
8,8,8,8,8,8,8,8,8,6,6,6,6,6,6,8,6,6,6,6,
0,0,0