0,5,7,7,5,5,1,3,3,3,1,2,1,5,1,2,0,7,1,6,
7,1,2,1,2,1,7,5,3,3,0,2,1,5,1,2,1,1,0,2,
1,2,3,1,0,0,2,7,1,0,2,1,1,1,7,0,1,2,1,1,
8,8,0,2,1,1,7,1,5,5,1,7,2,0,2,0,1,2,1,2,
3,5,5,5,3,3,5,2,1,5,3,2,2,1,2,0,2,1,0,3,
3,5,5,3,2,5,1,5,0,3,7,1,1,5,7,2,2,4,0,2,
5,3,0,3,1,3,5,1,1,5,1,0,0,5,2,2,1,1,3,5,
7,1,3,3,8,1,3,2,1,2,7,0,2,1,3,0,3,5,5,1,
1,2,3,3,3,3,5,7,5,0,2,2,0,2,0,2,1,7,1,2,
3,1,2,3,5,1,1,1,1,7,7,1,2,7,5,5,3,1,2,1,
17,5,1