0,5,1,5,6,3,2,2,2,1,2,1,2,0,1,1,2,2,0,0,
2,5,1,3,2,3,5,1,2,8,1,2,0,2,8,8,7,1,1,3,
5,1,0,0,1,7,0,3,2,1,3,0,0,0,5,1,1,3,2,3,
1,5,0,0,8,1,7,1,1,2,4,1,0,0,1,2,2,0,1,3,
5,3,3,7,1,3,1,1,5,7,2,2,0,2,0,1,1,8,2,2,
5,2,2,0,7,5,5,2,5,2,3,3,2,0,1,0,1,2,2,1,
2,0,7,1,2,1,1,1,2,2,2,1,1,0,7,2,2,1,1,2,
3,1,3,1,3,5,3,5,3,1,1,1,2,2,0,1,1,1,2,0,
1,5,5,2,5,1,1,7,5,0,3,2,2,0,0,0,0,1,1,2,
2,1,2,1,5,2,1,5,1,2,8,3,0,2,0,1,5,1,3,2,
10,3,1