0,2,1,2,3,2,1,1,3,2,2,0,1,2,2,2,1,5,2,0,
3,3,3,1,3,1,3,2,2,1,3,3,2,0,2,0,5,2,0,1,
0,3,5,3,3,1,1,1,1,5,0,0,3,0,3,3,3,1,2,1,
1,1,3,3,3,3,5,1,2,2,1,5,2,1,5,3,5,5,0,1,
3,3,3,5,4,3,3,3,1,3,1,5,3,3,3,7,2,1,1,1,
5,1,2,2,4,3,5,1,3,5,3,0,3,1,2,2,1,5,2,1,
0,3,1,5,2,2,2,3,2,0,1,1,5,3,3,0,2,2,1,2,
7,3,3,1,3,3,1,3,1,2,3,1,1,3,2,1,1,2,5,3,
3,5,3,5,5,3,5,3,4,0,5,1,1,5,1,1,5,1,5,3,
5,1,5,3,3,5,3,7,2,0,1,5,5,3,1,1,3,2,7,2,
