0,3,3,3,3,1,3,2,3,3,3,5,7,2,2,2,0,1,5,1,
1,5,3,3,3,3,3,1,3,2,1,3,1,1,5,0,1,2,3,2,
1,3,4,4,4,2,5,5,3,7,5,1,3,2,1,2,1,0,2,7,
1,3,5,1,1,5,7,3,7,2,1,2,1,1,2,2,5,1,3,2,
5,5,3,5,3,3,5,1,1,0,5,1,5,2,7,1,1,2,0,1,
1,3,5,3,3,3,3,2,0,2,1,3,1,3,5,5,2,7,1,5,
3,3,3,5,5,3,3,3,2,3,3,1,2,2,0,2,0,2,5,3,
5,3,3,3,3,1,5,1,1,3,0,5,2,1,1,5,3,5,2,2,
2,5,3,5,3,3,5,3,2,2,1,1,5,1,1,2,1,5,3,2,
1,3,2,1,5,3,3,2,5,3,3,2,7,1,2,1,3,0,5,7,
