0,3,5,7,5,3,1,3,3,1,2,3,1,1,1,5,3,1,1,5,
3,7,1,2,3,5,3,2,7,3,1,5,1,5,5,3,5,1,1,3,
3,2,3,3,5,1,3,3,1,3,3,1,2,1,3,2,1,3,1,1,
3,7,3,4,3,5,3,3,2,2,2,1,1,2,3,0,1,3,2,5,
3,2,3,3,3,3,3,2,7,0,1,3,2,1,5,1,2,7,1,2,
2,7,0,3,5,3,3,5,0,1,2,2,1,1,2,5,3,0,0,1,
1,1,5,1,5,3,1,3,5,1,5,2,5,2,0,3,3,2,0,2,
3,2,3,5,3,3,1,3,2,5,2,7,0,0,0,0,2,1,1,5,
3,5,1,3,2,3,5,5,2,2,1,1,5,1,1,1,1,5,2,0,
3,0,5,3,3,3,3,3,2,1,1,3,7,1,2,5,2,1,1,0,
